w,w,w,w,w,w,w
w,w,s,s,s,w,w
w,w,s,w,c,w,w
w,w,s,m,s,s,w
w,s,d,w,c,s,w
w,s,d,s,s,w,w
w,s,d,w,c,w,w
w,w,s,s,s,w,w
w,w,w,w,w,w,w
