w,w,w,w,w,w,w,w
w,w,w,s,s,s,w,w
w,s,s,cd,w,s,w,w
w,s,w,s,s,cd,s,w
w,s,cd,s,s,w,s,w
w,w,s,w,md,s,s,w
w,w,s,s,s,c,w,w
w,w,w,w,s,s,w,w
w,w,w,w,w,w,w,w
