w,w,w,w,w,w,w
w,w,s,s,s,w,w
w,s,s,w,d,w,w
w,s,c,c,d,s,w
w,w,s,m,s,s,w
w,w,s,w,d,s,w
w,w,s,c,s,w,w
w,w,s,w,w,w,w
w,w,s,s,w,w,w
w,w,s,s,w,w,w
w,w,s,s,w,w,w
w,w,w,w,w,w,w
