w,w,w,w,w,w,w,w
w,w,w,w,s,s,w,w
w,s,s,c,s,s,w,w
w,s,w,c,w,s,s,w
w,s,s,c,s,s,s,w
w,d,w,w,w,s,s,w
w,d,w,w,w,w,s,w
w,d,s,m,s,s,s,w
w,w,w,w,w,w,w,w
