w,w,w,w,w,w,w
w,w,s,s,s,w,w
w,w,d,w,c,w,w
w,w,s,s,s,s,w
w,w,d,w,c,s,w
w,w,s,s,s,w,w
w,w,d,w,c,w,w
w,w,s,s,s,w,w
w,s,d,w,c,w,w
w,s,m,s,s,w,w
w,s,s,w,w,w,w
w,w,w,w,w,w,w
