w,w,w,w,w,w,w,w,w,w
w,w,w,w,w,w,s,s,w,w
w,w,s,c,s,s,s,s,w,w
w,w,s,w,d,w,w,c,w,w
w,s,s,w,s,m,d,s,w,w
w,s,s,d,c,s,w,s,w,w
w,w,s,w,w,d,w,s,s,w
w,w,s,s,s,s,c,s,s,w
w,w,s,s,w,w,w,w,w,w
w,w,w,w,w,w,w,w,w,w
