w,w,w,w,w,w,w,w,w,w
w,s,s,s,d,w,w,w,w,w
w,s,d,s,m,w,w,w,w,w
w,s,w,s,w,w,w,w,w,w
w,s,w,s,c,s,w,w,w,w
w,s,cd,d,s,s,s,w,w,w
w,w,w,w,s,c,c,s,w,w
w,w,w,w,w,s,s,s,s,w
w,w,w,w,w,w,s,s,s,w
w,w,w,w,w,w,w,w,w,w
