w,w,w,w,w,w,w,w,w,w
w,w,w,w,w,s,s,s,w,w
w,s,s,s,w,c,w,s,s,w
w,s,s,s,c,d,m,w,s,w
w,w,s,w,w,d,d,s,s,w
w,s,s,w,d,s,s,w,w,w
w,s,s,c,s,c,s,w,w,w
w,s,s,w,w,w,w,w,w,w
w,w,w,w,w,w,w,w,w,w
