w,w,w,w,w,w,w
w,s,s,s,s,w,w
w,s,s,cd,s,s,w
w,s,c,cd,c,s,w
w,w,s,cd,s,w,w
w,w,s,cd,s,w,w
w,w,s,d,s,w,w
w,w,w,md,w,w,w
w,w,w,w,w,w,w
