w,w,w,w,w,w,w,w,w,w
w,w,w,w,w,w,s,s,s,w
w,w,s,c,s,d,s,w,s,w
w,w,s,w,s,c,c,s,s,w
w,w,s,w,w,s,w,s,w,w
w,s,s,c,d,c,d,s,w,w
w,s,w,w,s,s,s,w,w,w
w,s,s,d,m,d,w,w,w,w
w,w,w,w,w,w,w,w,w,w
