w,w,w,w,w,w,w,w,w
w,w,w,s,s,s,w,w,w
w,w,s,s,s,s,s,s,w
w,w,cd,w,cd,w,cd,s,w
w,w,s,w,m,c,s,w,w
w,w,s,w,s,w,d,w,w
w,s,s,s,s,s,s,w,w
w,s,s,s,w,s,s,w,w
w,w,w,w,w,w,w,w,w
