w,w,w,w,w,w,w,w
w,w,w,d,m,w,w,w
w,s,s,s,s,s,s,w
w,s,cd,d,d,w,s,w
w,w,s,w,c,c,s,w
w,w,s,s,s,s,w,w
w,w,w,c,w,s,w,w
w,w,w,s,s,s,w,w
w,w,w,w,w,w,w,w
