w,w,w,w,w,w,w,w
w,w,w,s,s,s,w,w
w,w,w,cd,w,s,w,w
w,s,s,s,s,cd,s,w
w,s,w,s,s,w,s,w
w,s,cd,s,md,s,s,w
w,w,s,s,w,c,w,w
w,w,w,s,s,s,w,w
w,w,w,w,w,w,w,w
