w,w,w,w,w,w,w,w,w,w
w,s,s,w,w,w,s,s,w,w
w,s,s,c,s,c,s,s,w,w
w,s,c,w,d,w,w,s,w,w
w,w,s,s,d,s,s,s,w,w
w,w,s,d,m,d,w,c,s,w
w,w,w,s,w,s,s,s,s,w
w,w,w,s,s,s,w,w,w,w
w,w,w,w,w,w,w,w,w,w
