w,w,w,w,w,w,w,w,w
w,w,w,w,w,w,s,s,w
w,w,s,c,s,c,s,s,w
w,w,d,w,s,w,d,s,w
w,w,s,c,m,c,s,w,w
w,w,d,w,s,w,d,w,w
w,s,s,cd,s,cd,s,s,w
w,s,s,s,w,s,s,s,w
w,w,w,w,w,w,w,w,w
