w,w,w,w,w,w,w,w,w
w,w,w,s,s,s,w,w,w
w,w,w,cd,w,s,c,s,w
w,s,c,s,m,s,w,s,w
w,s,w,s,d,d,s,s,w
w,s,d,s,w,c,w,w,w
w,w,c,d,s,s,w,w,w
w,w,s,s,w,w,w,w,w
w,w,w,w,w,w,w,w,w
