w,w,w,w,s,s,s,s,s,s,s,s,s
w,s,s,w,w,w,w,w,w,w,w,w,s
w,s,s,s,s,w,w,s,s,s,s,w,s
w,s,c,c,c,w,s,s,s,s,s,w,s
w,w,d,d,d,w,s,w,c,c,c,w,s
w,w,d,d,d,w,s,w,d,d,d,w,s
w,w,c,c,c,s,s,w,d,d,d,w,w
w,w,s,s,s,s,w,w,c,c,c,s,w
w,w,w,w,w,w,w,w,s,m,s,s,w
w,w,w,w,w,w,w,w,w,w,w,w,w
