w,w,w,w,w,w,w,w
w,w,s,s,s,w,w,w
w,w,s,w,c,s,m,w
w,s,d,s,c,s,s,w
w,d,d,d,w,c,w,w
w,s,w,s,s,c,s,w
w,s,s,w,s,s,s,w
w,w,s,s,s,w,w,w
w,w,w,w,w,w,w,w
