w,w,w,w,w,w,w,w,w,w
w,w,w,s,s,s,w,s,s,w
w,w,w,s,s,s,c,d,s,w
w,w,w,w,c,w,w,s,s,w
w,w,s,c,d,w,w,s,w,w
w,w,s,s,d,cd,s,s,s,w
w,s,s,w,c,w,s,s,s,w
w,s,d,m,s,w,w,w,w,w
w,w,s,s,s,w,w,w,w,w
w,w,w,w,w,w,w,w,w,w
