w,w,w,w,w,w,w,w,w
w,w,w,w,w,s,s,w,w
w,s,c,s,s,s,c,w,w
w,s,s,d,w,d,s,w,w
w,w,s,w,w,w,s,w,w
w,w,s,d,w,d,s,s,w
w,w,c,s,m,s,c,s,w
w,w,s,s,w,w,w,w,w
w,w,w,w,w,w,w,w,w
