w,w,w,w,w,w,w,w,w
w,w,s,s,w,w,w,w,w
w,w,s,s,s,c,s,s,w
w,w,c,w,s,w,s,s,w
w,w,s,s,md,s,s,w,w
w,s,s,w,d,w,c,w,w
w,s,s,c,d,s,s,w,w
w,w,w,s,d,s,w,w,w
w,w,w,w,w,w,w,w,w
