w,w,w,w,w,w,w,w,w,w
w,w,w,s,s,w,w,w,w,w
w,s,s,s,s,w,w,w,w,w
w,s,s,w,s,s,w,w,w,w
w,w,s,d,s,d,s,d,w,w
w,w,c,w,w,d,w,c,w,w
w,s,c,s,s,m,s,c,s,w
w,s,s,s,w,w,s,s,s,w
w,w,w,w,w,w,w,w,w,w
