w,w,w,w,w,w,w,w,w,w,w
w,w,w,w,w,w,s,s,w,w,w
w,s,s,s,s,s,s,s,s,w,w
w,s,s,c,s,w,d,w,s,w,w
w,s,s,c,w,w,s,w,s,w,w
w,w,w,s,s,s,m,s,s,s,w
w,w,w,w,w,s,s,w,s,s,w
w,w,w,w,w,w,d,s,s,w,w
w,w,w,w,w,w,w,w,w,w,w
