w,w,w,w,w,w,w,w
w,w,s,s,s,w,w,w
w,w,d,w,c,s,w,w
w,s,c,s,s,s,s,w
w,d,s,d,w,c,s,w
w,w,w,s,m,s,w,w
w,w,w,s,w,s,w,w
w,w,w,s,s,s,w,w
w,w,w,w,w,w,w,w
