w,w,w,w,w,w,w,w
w,s,s,s,w,s,s,w
w,s,s,s,s,s,s,w
w,w,s,w,d,s,s,w
w,s,s,s,s,w,w,w
w,s,w,s,d,s,w,w
w,s,c,c,w,s,w,w
w,w,w,s,s,m,w,w
w,w,w,w,w,w,w,w
