w,w,w,w,w,w,w,w
w,s,s,w,w,w,w,w
w,s,s,s,s,s,w,w
w,s,s,s,s,s,w,w
w,w,w,s,w,w,w,w
w,s,c,c,s,s,w,w
w,s,d,s,d,m,s,w
w,w,w,w,s,s,s,w
w,w,w,w,w,w,w,w
