w,w,w,w,w,w,w
w,s,s,s,w,w,w
w,s,d,s,s,s,w
w,w,s,c,s,s,w
w,w,w,w,c,w,w
w,s,s,c,s,w,w
w,s,m,s,s,s,w
w,w,w,d,s,d,w
w,w,w,w,w,w,w
