w,w,w,w,w,w,w,w,w
w,w,w,w,w,w,s,s,w
w,w,w,w,s,d,d,s,w
w,w,s,c,c,w,s,s,w
w,w,s,w,s,w,m,w,w
w,s,s,cd,s,s,s,s,w
w,s,s,s,w,s,s,s,w
w,w,w,w,w,w,s,s,w
w,w,w,w,w,w,w,w,w
