w,w,w,w,w,w,w,w,w
w,w,w,w,w,s,s,w,w
w,w,s,c,s,s,s,w,w
w,s,s,w,s,w,c,w,w
w,d,m,d,d,s,s,w,w
w,w,s,w,s,w,s,s,w
w,w,s,s,s,c,s,s,w
w,w,s,s,w,w,w,w,w
w,w,w,w,w,w,w,w,w
