w,w,w,w,w,w,w,w
w,w,w,w,w,s,s,w
w,s,s,s,c,s,s,w
w,s,s,d,w,s,s,w
w,w,s,w,w,s,w,w
w,s,s,s,s,s,s,w
w,s,m,w,s,s,s,w
w,s,s,w,w,w,w,w
w,w,w,w,w,w,w,w
