w,w,w,w,w,w,w,w
w,w,w,s,s,s,w,w
w,s,s,s,s,s,w,w
w,s,s,w,d,w,w,w
w,w,m,c,c,c,s,w
w,w,d,w,d,w,s,w
w,w,s,s,s,s,s,w
w,w,s,s,w,w,w,w
w,w,w,w,w,w,w,w
