w,w,w,w,w,w,w,w
w,w,w,w,w,s,s,w
w,s,s,s,cd,s,s,w
w,s,cd,d,w,s,s,w
w,w,s,w,w,s,w,w
w,s,c,s,s,s,s,w
w,s,m,w,s,s,s,w
w,s,s,w,w,w,w,w
w,w,w,w,w,w,w,w
