w,w,w,w,w,w,w,w
w,w,s,s,w,w,w,w
w,w,s,s,s,s,s,w
w,w,s,w,d,s,s,w
w,w,cd,w,w,c,w,w
w,s,s,s,s,s,s,w
w,s,w,s,m,s,s,w
w,s,s,s,s,w,w,w
w,w,w,w,w,w,w,w
