w,w,w,w,w,w,w,w,w,w
w,w,w,w,w,s,s,s,w,w
w,w,w,w,s,d,w,s,s,w
w,w,w,s,s,s,m,s,s,w
w,w,s,s,s,s,w,s,s,w
w,s,s,c,s,w,w,w,w,w
w,s,cd,s,w,w,w,w,w,w
w,s,s,w,w,w,w,w,w,w
w,w,w,w,w,w,w,w,w,w
