w,w,w,w,w,w,w
w,w,w,s,s,w,w
w,w,s,s,s,w,w
w,s,s,cd,c,s,w
w,s,w,s,w,m,w
w,s,s,cd,d,s,w
w,w,w,s,s,w,w
w,w,w,s,s,w,w
w,w,w,w,w,w,w
