w,w,w,w,w,w,w,w
w,s,s,w,w,w,w,w
w,s,s,s,s,s,w,w
w,s,s,s,s,s,w,w
w,w,w,s,w,w,w,w
w,s,c,c,c,s,w,w
w,s,d,d,d,m,s,w
w,w,w,w,s,s,s,w
w,w,w,w,w,w,w,w
